EA textures/east_wall.xpm
NO textures/north_wall.xpm
SO textures/south_wall.xpm
WE textures/west_wall.xpm

C 153,255,255
F 64,64,64

     11111111111111111111
     10001000000000100001
     10000000000100000001
111111000001N000000000001
1000000000011100000000001
100110000000111100011111111
1000000000001  100000000001
1000000000001  100000000001
100000000000111100000000111
1000000000000000000000001
1000000100000000000000001
1111111000000111000000001111111
      1111100100000000000000001
          100000000000000000001
          111111111111111111111